1111111111111111111111111111111111111111111111
10010000000C0000000000000000000000000000000001
1000011111000000000000000000000000000000000001
1000110000000000000000000000000000000000000001
1000110000000000000000000000000000000000000001
1000110000000000000000000000000000000000000001
1000110000000000000000000000000000000000000001
1000110000000000000000000000000000000000000001
1000110000000000000000000000000000000000000001
1000110000000000000000000000000000000000000001
1000110000000000000000000000000000000000000001
1000110000000000000000000000000000000000000001
1000110000000000000000000000000000000000000001
1000110000000000000000000000000000000000000001
1000110000000000000000000000000000000000000001
1000110000000000000000000000000000000000000001
1000110000000000000000000000000000000000000001
1000110000000000000000000000000000000000000001
1000110000000000000000000000000000000000000001
1000110000000000000000000000000000000000000001
1000110000000000000000000000000000000000000001
1000110000000000000000000000000000000000000001
1P0011E000000000000000000000000000000000000001
1111111111111111111111111111111111111111111111