1111111111111111111111111111111111111111111111
1001000000000000000000000000000000000000000001
10P0011111000000000000000000000000000000000001
1000110000000000000000000000000000000000000001
1000110000000000000000000000000000000000000001
1000110000000000000000000000000000000000000001
1000110000000000000000C00000000000000000000001
1000110000000000000000000000000000000000000001
1000110000000000000000000000000000000000000001
1000110000000000000000000000000000000000000001
1000110000000000000000000000000000000000000001
1000110000000000000000000000000000000000000001
1000110000000000000000000000000000000000000001
1000110000000000000000000000000000000000000001
100011000000000000000000C000000000000000000001
1000110000000000000000000000000000000000000001
1000110000000000000000000000000000000000000001
1000110000000000000000000000000000000000000001
1000110000000000000000000000000000000000000001
1000110000000000000000000000000000000000000001
1000110000000000000000000000000000000000000001
1000110000000000000000000000000000000000000001
1E00110000000000000000000000000000000000000001
1111111111111111111111111111111111111111111111