1111111111111
1C01000000001
10P0011111001
1E0P110000001
1111111111111